"nickname","Account_blocked","Account_changed","Copyright_infringement","Deleted_by_the_account_owner","Violating_internet_laws","total_takedown"
"074职场女性法律热线",0,0,0,1,0,1
"1818黄金眼",0,0,0,1,0,1
"21CTO",0,0,1,0,0,1
"21世纪国情报道",0,0,0,1,0,1
"3D人",0,0,0,0,5,5
"45区",0,0,0,0,1,1
"630很有料",0,0,0,3,0,3
"686新闻工厂",0,0,0,3,0,3
"706青年空间",0,0,0,2,0,2
"8090军事独家纵览",0,0,0,8,1,9
"90后洞见",0,0,0,0,7,7
"9号工馆",0,0,0,1,0,1
"Aha视频",0,0,1,0,0,1
"AHTV法治时空",0,0,0,5,0,5
"Aires行记",0,0,0,1,0,1
"AI蓝媒汇",0,0,0,1,1,2
"BCome女权小组",0,0,0,0,1,1
"beebee星球",0,0,0,1,0,1
"bookface",0,0,0,2,1,3
"Boss学习圈",0,0,0,10,0,10
"CGTNOfficial",0,0,0,0,1,1
"CHINADAILY",0,0,0,1,0,1
"Civil Rights",0,0,0,0,7,7
"CSDN",0,0,1,4,1,6
"DeepTech深科技",0,0,0,4,1,5
"DT财经",0,0,0,4,0,4
"ELLEMEN睿士",0,0,0,2,0,2
"E安全",0,0,0,1,0,1
"e观沧海",0,0,0,0,1,1
"FM107太原交通广播",0,0,0,4,0,4
"FT中文网",0,0,0,0,5,5
"FUN来了233",0,0,0,1,0,1
"GQ实验室",0,0,0,2,0,2
"Herstoria",0,0,0,0,1,1
"Herstorien",3,0,0,0,0,3
"HGP小组",0,0,0,1,0,1
"historicize",0,0,0,0,3,3
"hladrv",0,0,0,0,5,5
"HUGO",0,0,0,7,1,8
"idolife星生活",0,0,0,1,0,1
"iFeng科技",0,0,0,1,0,1
"ijingjie",0,0,0,1,0,1
"InsightsInfo",0,0,0,0,2,2
"INSIGHT视界",0,0,0,2,1,3
"IT之家",0,0,0,1,0,1
"iWeekly周末画报",0,0,0,2,1,3
"i沂南",0,0,0,2,0,2
"i黑马",0,0,0,16,3,19
"Java技术栈",0,0,0,5,0,5
"LADYMAX",0,0,0,1,0,1
"LES",0,0,0,1,0,1
"LGBT彩虹社",0,0,0,1,0,1
"Linux中国",0,0,0,2,0,2
"lnstagram优选",0,0,0,2,0,2
"LoveRediscover",0,0,0,1,0,1
"McGill大学中国研究生会",0,0,0,1,0,1
"MelanieWang",1,0,0,0,0,1
"NYT教育频道",0,0,0,0,3,3
"OC海外校园",1,0,0,0,0,1
"OTTAWAZINE",0,0,0,1,0,1
"P2P观察",0,0,1,10,1,12
"PacifiLink飞洋在线",0,0,0,0,1,1
"PingPong订阅号",0,0,0,2,1,3
"PingWest品玩",0,0,0,1,0,1
"POLICEman",0,0,0,3,0,3
"Purple",0,0,0,1,0,1
"ShanghaiWOWeng",0,0,0,1,0,1
"Socialmouths",0,0,1,0,0,1
"theBeijinger",0,0,0,1,1,2
"UCTV区块链频道",0,0,0,1,0,1
"Ujoy",0,0,0,0,1,1
"U台说",0,0,0,0,1,1
"VC股权投资",0,0,0,3,2,5
"VICE",0,0,0,3,1,4
"Vista看天下",0,0,0,4,2,6
"WeLens",0,0,0,1,1,2
"X博士",0,0,0,1,1,2
"ZAKER",0,0,0,4,3,7
"一个回民的呐喊",0,0,0,1,0,1
"一个程序员的日常",0,0,0,1,0,1
"一冬羊",0,0,0,0,1,1
"一号专案",0,0,0,1,0,1
"一席",0,0,0,2,0,2
"一平米的咖啡屋",0,0,0,2,0,2
"一时半刻",0,0,0,1,0,1
"一本财经",0,0,0,1,0,1
"一条",0,0,0,1,1,2
"一枚石头",0,0,0,1,0,1
"一瓣",0,0,0,1,0,1
"一禅小屋",0,0,0,3,0,3
"丁东小群",0,0,0,0,2,2
"丁咚",0,0,0,3,5,8
"丁香医生",0,0,0,4,0,4
"丁香园",0,0,0,1,0,1
"七书先生",0,0,1,1,0,2
"七色棒棒糖",0,0,0,9,2,11
"万小刀",0,0,0,3,1,4
"万能的布丁",0,0,1,0,0,1
"万象",0,0,0,6,0,6
"万象镜",0,0,0,7,2,9
"三上文存",0,0,0,22,4,26
"三亚政务",0,0,0,1,0,1
"三声",0,0,0,4,0,4
"三明治",0,0,0,1,0,1
"三男一宅",0,0,0,1,1,2
"三联生活周刊",0,0,0,5,2,7
"三表龙门阵",0,0,0,0,1,1
"上善建水",0,0,0,1,0,1
"上流UpFlow",0,0,0,2,0,2
"上海宝山",0,0,0,1,0,1
"上海师范大学",0,0,0,1,0,1
"上海普陀",0,0,0,1,0,1
"上海植物园",0,0,0,1,0,1
"上海虹口",0,0,0,3,0,3
"上海证券报",0,0,0,1,0,1
"上海译文",0,0,0,2,0,2
"上海长宁",0,0,0,1,0,1
"上观新闻",0,0,1,1,0,2
"不是官话",0,0,0,3,4,7
"世界之声",0,0,0,4,2,6
"世界华人周刊",0,0,0,4,0,4
"世界华人杂谈",0,0,0,0,6,6
"世界经济论坛",0,0,0,1,0,1
"世界说",0,0,0,3,2,5
"世纪观察",0,0,0,1,3,4
"世纪讲坛",0,0,0,0,2,2
"东南早报",0,0,0,4,0,4
"东南网",0,0,0,6,0,6
"东南网播报",0,0,0,1,0,1
"东方剑客",0,0,0,2,0,2
"东方历史评论",0,0,0,1,2,3
"东方时事",0,0,0,3,1,4
"东方网",0,0,0,5,1,6
"东海岛小城大事",0,0,0,2,1,3
"丽水经济技术开发区",0,0,0,3,0,3
"丽水网",0,0,0,1,0,1
"丫丫港股圈",0,0,0,1,0,1
"中东研究通讯",0,0,0,3,0,3
"中产读本",0,0,0,1,6,7
"中企思智库",0,0,0,6,1,7
"中华参考",0,0,0,3,1,4
"中华好学者",0,0,0,0,5,5
"中华焦点",0,0,0,2,0,2
"中南财经政法大学",0,0,0,2,0,2
"中国与全球化智库",0,0,0,0,4,4
"中国中医",0,0,0,4,0,4
"中国之声",0,0,0,9,0,9
"中国企业家杂志",0,0,0,3,2,5
"中国信息通信研究院CAICT",0,0,0,15,0,15
"中国化学品安全协会",0,0,0,9,1,10
"中国反邪教",0,0,1,0,0,1
"中国发展观察",0,0,0,1,0,1
"中国哈萨克语广播CNR",0,0,0,1,0,1
"中国基金报",0,0,0,26,6,32
"中国妇女报",0,0,0,4,0,4
"中国宣恩网",0,0,0,2,0,2
"中国房地产报",0,0,0,10,0,10
"中国搜索",0,0,0,2,0,2
"中国文明网",0,0,0,3,0,3
"中国文艺评论",0,0,0,2,0,2
"中国新闻周刊",0,0,0,8,0,8
"中国新闻社",0,0,0,2,0,2
"中国新闻网",0,0,0,6,0,6
"中国日报双语新闻",0,0,0,1,0,1
"中国法律文书网",0,0,0,0,4,4
"中国法律评论",0,0,0,0,1,1
"中国环境新闻",0,0,0,3,0,3
"中国环境监测",0,0,0,10,0,10
"中国电业",0,0,0,1,0,1
"中国电影导演协会",0,0,0,1,0,1
"中国知识产权杂志",0,0,0,6,0,6
"中国社会科学网",0,0,0,12,0,12
"中国社会组织动态",0,0,0,5,0,5
"中国纱线网",0,0,0,3,2,5
"中国经济时报",0,0,0,1,0,1
"中国经济网",0,0,1,0,0,1
"中国缝制机械协会",0,0,0,1,0,1
"中国美术",0,0,0,2,0,2
"中国舆情智库",0,0,0,0,1,1
"中国艺术家",0,0,0,3,1,4
"中国艾协动态",0,0,0,6,1,7
"中国藏语广播CNR",0,0,0,1,0,1
"中国证券报",0,0,0,15,0,15
"中国证券网",0,0,0,1,1,2
"中国镍业网",0,0,1,0,0,1
"中国青年报",0,0,0,1,0,1
"中国驻俄罗斯大使馆",0,0,0,2,0,2
"中国驻哈萨克斯坦大使馆",0,0,0,1,0,1
"中国驻毛里求斯大使馆",0,0,0,1,0,1
"中塔塔罗网",0,0,0,1,0,1
"中山大学环境学院",0,0,0,3,0,3
"中山政协",0,0,0,1,0,1
"中文在线",0,0,0,1,0,1
"中新生态城发布",0,0,0,1,0,1
"中欧商业评论",0,0,0,2,0,2
"中穆前沿",5,0,0,2,1,8
"中童观察",0,0,0,1,0,1
"中美印象网",0,0,0,0,3,3
"中西ABC",0,0,0,6,4,10
"中评社",0,0,0,1,0,1
"中金在线",0,0,0,8,0,8
"临淄基督教",0,0,0,1,1,2
"义乌教育之声",0,0,0,5,0,5
"丹寨万达小镇",0,0,0,1,0,1
"丹顶鹤",0,0,0,12,1,13
"为你写一个故事",0,0,1,4,3,8
"为道而阅",0,0,0,1,1,2
"主流看点",0,0,0,8,10,18
"乌鲁木齐交警",0,0,0,1,0,1
"乌鲁木齐零距离",0,0,0,1,0,1
"乐山发布",0,0,0,4,0,4
"乐见岛",0,0,0,0,1,1
"乐诚坊",0,0,0,0,2,2
"九品西瓜官",0,0,0,3,3,6
"九江论坛",0,0,0,4,0,4
"书房记",0,0,1,10,2,13
"书法欣赏",0,0,0,1,0,1
"乱码",0,0,0,0,2,2
"乾元国学",0,0,0,1,0,1
"了不起我的国",0,0,0,1,0,1
"二手见闻",0,0,0,10,4,14
"于此聚焦2",0,0,0,2,4,6
"云南平行",0,0,0,1,0,1
"云南网",0,0,0,8,0,8
"云岭先锋",0,0,0,2,0,2
"云石",0,0,0,18,4,22
"互联网联合辟谣平台",0,0,0,3,0,3
"五华零距离",0,0,0,1,0,1
"五寨广播电视微频道",0,0,0,2,0,2
"五杀电影",0,0,0,3,0,3
"五楼的瞭望者",0,0,0,1,1,2
"五色金砖",0,0,0,0,3,3
"亚刊智库",4,0,0,4,9,17
"亚心网",0,0,0,2,0,2
"亚汇金融",0,0,0,0,1,1
"亚洲资讯",0,0,1,7,3,11
"亚生看G2",0,0,0,1,2,3
"亚美时政学堂",3,0,0,0,17,20
"交通中山",0,0,0,1,0,1
"享海外",0,0,0,0,2,2
"京剧",0,0,0,5,0,5
"京平拆迁律师",0,0,0,1,0,1
"亮剑发声",0,0,0,1,0,1
"亮宝楼",0,0,0,2,0,2
"亲友会PFLAG",0,0,0,1,0,1
"人人文荟",0,0,0,2,0,2
"人工智能学家",0,0,1,0,1,2
"人文学会",0,0,0,0,5,5
"人民日报",0,0,0,8,0,8
"人民视野2018",0,0,0,17,7,24
"人民网",0,0,0,14,0,14
"人民网上海",0,0,1,1,0,2
"人民网江苏频道",0,0,0,3,1,4
"人民网海南频道",0,0,0,2,0,2
"人物",0,0,0,0,3,3
"人生茶馆",0,0,0,0,6,6
"人间theLivings",0,0,0,2,3,5
"人间正道话沧桑",0,0,1,3,3,7
"今日南江",0,0,1,2,0,3
"今日南漳",0,0,0,1,0,1
"今日台湾",0,0,0,1,0,1
"今日平说",0,0,0,1,0,1
"今日平说订阅号",0,0,0,0,4,4
"今日废塑料",0,0,2,0,0,2
"今日微察",0,0,0,1,6,7
"今日悉尼",0,0,0,0,1,1
"今日斗门",0,0,0,2,0,2
"今日法条",0,0,0,6,0,6
"今日海州",0,0,0,2,0,2
"今日观察",0,0,0,13,12,25
"今日话题",0,0,0,2,0,2
"今日财经头条",0,0,0,0,5,5
"今日防务观察",0,0,0,6,6,12
"今日霍州",0,0,0,1,0,1
"今日墨尔本",0,0,0,1,0,1
"他趣情趣体验社",0,0,0,2,1,3
"仗法执言",0,0,0,0,2,2
"令狐挽报",0,0,0,20,0,20
"仪器信息网",0,0,0,2,0,2
"伊光网",0,0,0,0,1,1
"伊兰心灵课堂",0,0,0,0,1,1
"休斯顿在线",0,0,0,1,0,1
"优抚咨询服务部",0,0,0,11,2,13
"优粮DX",0,0,0,1,0,1
"伟业信息广告",0,0,0,0,3,3
"传奇雄韬",0,0,0,0,7,7
"传媒大观察",0,0,0,1,0,1
"似曾相识12",0,0,0,0,2,2
"何帆工作室",0,0,0,1,0,1
"余世存工作室",0,0,0,0,2,2
"佛山发布",0,0,0,1,0,1
"佛州百事通",0,0,0,4,0,4
"作家树",0,0,0,1,0,1
"佳人",0,0,0,4,0,4
"依然猛料",0,0,0,23,0,23
"侠客岛",0,0,0,9,0,9
"保二爷",0,1,0,0,0,1
"保马",0,0,0,0,1,1
"信仰的力量",0,0,0,1,0,1
"修和書院",0,0,0,1,5,6
"债市覃谈",0,0,0,1,2,3
"倾听婚姻",0,0,0,19,1,20
"假装在纽约",0,0,0,1,1,2
"做書",0,0,0,2,1,3
"健康罗湖",0,0,0,1,0,1
"偶尔治愈",0,0,0,1,1,2
"偶见",0,0,1,30,0,31
"先生手账",0,0,0,3,1,4
"光明论",0,0,0,3,0,3
"克拉玛依日报",0,0,0,1,0,1
"克而瑞地产研究",0,0,0,9,0,9
"全媒派",0,0,0,0,1,1
"全是黑科技",0,0,0,1,0,1
"全民军网",0,0,0,3,1,4
"全球博弈",0,0,0,0,2,2
"全球妈妈",0,0,0,0,6,6
"全球富豪圈",0,0,1,2,0,3
"全球局部战略",0,0,0,11,0,11
"全球政事",0,0,0,1,2,3
"全球福音之家",0,0,0,1,0,1
"全球见证分享网",0,0,0,1,0,1
"八点热刊",0,0,0,0,7,7
"公大资讯",0,0,0,4,4,8
"公子犯堂II",0,0,0,0,1,1
"公子镔",0,0,0,0,1,1
"公教福传团",0,0,0,1,0,1
"公益时报",0,0,0,4,0,4
"公路商店",0,0,0,1,0,1
"六品锦衣卫",0,0,0,2,0,2
"六安税务",0,0,0,1,0,1
"六神磊磊读金庸",0,0,0,1,2,3
"兰州公安",0,0,0,2,0,2
"兰斌强",2,0,0,0,0,2
"共同自由",0,0,0,2,6,8
"共想社",0,0,2,0,2,4
"共青团中央",0,0,1,3,0,4
"共青团阿克苏市委员会",0,0,0,1,0,1
"关注饶河",0,0,0,12,0,12
"兽楼处",0,0,1,0,1,2
"内蒙古日报",0,0,0,7,0,7
"内蒙古纪委监委",0,0,0,4,0,4
"内部密文",0,0,0,7,0,7
"最后一公里",0,0,0,1,0,1
"最寿光",0,0,0,5,0,5
"最爱大北京",0,0,0,2,3,5
"最爱大新疆",0,0,0,1,0,1
"最猛料",0,0,0,5,3,8
"最箴言",0,0,1,1,2,4
"最高人民检察院",0,0,0,1,0,1
"最高人民法院",0,0,0,5,0,5
"军事风云",0,0,0,9,1,10
"军备圈",15,0,1,11,12,39
"军报记者",0,0,0,2,1,3
"军机特报",0,0,0,11,4,15
"军武榜",0,0,0,15,6,21
"农合论坛官网",0,0,0,4,0,4
"农合论坛网",0,0,0,1,0,1
"农村最新事",0,0,0,66,0,66
"农村印记",0,0,0,6,3,9
"冯站长之家",0,0,0,2,4,6
"决策参考",0,0,3,0,6,9
"决策杂志",0,0,0,7,2,9
"冷兔",0,0,1,2,0,3
"冷兵器研究所",0,0,0,3,0,3
"冷眼文摘",0,0,0,16,10,26
"凡人钒语",0,0,0,0,3,3
"凡夫俗子话财经",1,0,0,0,0,1
"凤凰WEEKLY",0,0,0,9,2,11
"凤凰卫视",0,0,0,1,0,1
"凤凰周刊智库",0,0,0,0,1,1
"凤凰网",0,0,0,2,5,7
"凤凰网时尚",0,0,0,3,0,3
"凤凰网读书",0,0,0,4,0,4
"凤凰网财经",0,0,0,109,12,121
"凤凰网青岛",0,0,0,6,0,6
"凤凰青岛",0,0,0,2,0,2
"処女座",0,0,0,146,1,147
"凭海观潮",0,0,0,1,6,7
"凭海观潮A",0,0,0,1,1,2
"凹凸镜DOC",0,0,0,1,0,1
"刑事正义",0,0,1,6,0,7
"刑事法律圈",0,0,0,14,0,14
"创业家",0,0,0,3,1,4
"创业财经汇",0,0,1,5,2,8
"创意邦",0,0,0,2,0,2
"创新工场",0,0,0,1,0,1
"初恩彩虹宝贝",0,0,0,1,0,1
"券商中国",0,0,0,8,3,11
"前沿观察网",0,0,1,40,4,45
"前沿解读",0,0,0,2,2,4
"前郭发布",0,0,0,1,0,1
"剑圣喵大师",0,0,0,8,0,8
"剧姐",0,0,0,4,0,4
"加入企业老板俱乐部",0,0,1,0,4,5
"加拿大中文报",0,0,0,1,2,3
"加拿大和美国必读",0,0,0,3,1,4
"动点科技",0,0,0,1,0,1
"动脉网",0,0,0,4,0,4
"动静贵州",0,0,0,8,0,8
"劳动法研究",0,0,0,0,3,3
"募格学术",0,0,0,2,0,2
"包邮区",0,0,0,0,2,2
"化工707",0,0,0,4,1,5
"北京京润律师事务所",0,0,0,2,0,2
"北京大妈有话说",0,0,0,0,3,3
"北京大学医学部",0,0,0,1,0,1
"北京师范大学成都实验中学",0,0,0,1,0,1
"北京新闻广播",0,0,0,6,0,6
"北斗局",0,0,1,41,12,54
"北方青杨",10,0,1,28,8,47
"北洋之家",0,0,0,1,0,1
"北美全知道",0,0,0,2,0,2
"北美华人之声",0,0,0,1,5,6
"北美留学生",0,0,0,2,0,2
"北美留学生日报",0,0,0,10,3,13
"医业观察",0,0,0,1,0,1
"医学界",0,0,0,2,1,3
"医麦客",0,0,0,5,0,5
"十分心理",0,0,0,1,0,1
"十分钟看世界",0,0,0,2,1,3
"十堰晚报",0,0,0,4,0,4
"十点人物志",0,0,0,3,0,3
"千人计划网",0,0,0,4,0,4
"千贤投资",0,0,0,13,12,25
"半岛晨报",0,0,0,5,1,6
"半月谈",0,0,0,2,0,2
"半老草根小雷雷",0,0,0,2,0,2
"华为行政服务-深圳",0,0,0,1,0,1
"华交会",0,0,0,1,0,1
"华人生活网",0,0,1,7,0,8
"华人知道",0,0,0,9,0,9
"华人蓝天",0,0,2,7,3,12
"华人讲堂",0,0,0,1,2,3
"华哥读报",0,0,0,17,7,24
"华商报",0,0,0,2,0,2
"华声",0,0,0,3,0,3
"华孙欧洲知识产权",0,0,0,1,0,1
"华宣",0,0,0,1,0,1
"华尔街见闻",0,0,0,1,0,1
"华广网",0,0,0,2,0,2
"华新爆料",0,0,0,0,5,5
"卓越早教网",0,0,0,1,0,1
"南京发布",0,0,0,2,0,2
"南京日报",0,0,0,2,0,2
"南京江北新区",0,0,0,1,0,1
"南北国事",0,0,0,3,0,3
"南半球之声",0,0,0,1,0,1
"南友圈",0,0,0,2,8,10
"南国早报",0,0,0,6,0,6
"南国都市报",0,0,0,7,0,7
"南师国学堂",0,0,0,5,2,7
"南方周末",0,0,0,3,0,3
"南方新闻网",0,0,1,0,0,1
"南方日报",0,0,0,3,1,4
"南方杂志",0,0,0,2,0,2
"南方能源观察",0,0,0,4,0,4
"南方都市报",0,0,1,13,0,14
"南昌晚报",0,0,0,2,0,2
"南极圈",0,0,0,6,0,6
"南海军事正在直播",0,0,0,15,0,15
"南艳青年",0,0,0,2,0,2
"南都周刊",0,0,0,10,0,10
"南风录",0,0,0,2,0,2
"博士学者圈",0,0,1,0,0,1
"占豪",0,0,0,1,5,6
"占豪说天下",0,0,0,0,4,4
"占领男厕所的李麦子",0,0,0,0,1,1
"卢璐说",0,0,0,2,0,2
"卫斯理观察",0,0,0,2,1,3
"历史与秩序",0,0,0,2,0,2
"历史之瞳",0,0,0,0,1,1
"历史之童",0,0,0,1,0,1
"历史微时刻",0,0,0,0,3,3
"历史袁老师",0,0,0,1,0,1
"参考消息",0,0,0,7,0,7
"友爱的宝武",0,0,0,1,0,1
"反传联盟",0,0,0,4,0,4
"反腐一号",0,0,0,7,4,11
"反腐倡廉智库",0,0,1,19,0,20
"反腐励剑",0,0,0,1,4,5
"反腐时事网",0,0,0,2,2,4
"反腐焦点",0,0,1,10,4,15
"反腐督查台",5,0,0,0,0,5
"反腐重拳",9,0,0,1,1,11
"发展共学",0,0,0,0,2,2
"发现新西兰",0,0,0,3,0,3
"发达服务中心",0,0,0,0,1,1
"取经号JTW",2,0,0,0,0,2
"叙拉古之惑",0,0,1,18,1,20
"古田发布",0,0,0,2,0,2
"叩叩财讯",0,0,0,1,2,3
"台州人社",0,0,0,1,0,1
"史客儿",0,0,0,1,0,1
"吃喝玩乐埃德蒙顿",0,0,2,0,0,2
"吉安发布",0,0,0,4,0,4
"同志生活圈",0,0,0,12,3,15
"名城苏州网",0,0,0,2,0,2
"后E视野",0,0,0,0,6,6
"后窗工作室",0,0,0,2,1,3
"吐小曹扒新闻",0,0,0,1,0,1
"吐槽星君",0,0,1,25,0,26
"吐槽电影院",0,0,0,2,1,3
"向阳花开杭州LGBT",0,0,0,2,0,2
"听道讲坛TnDao",0,0,0,1,0,1
"启阳路4号",0,0,0,3,1,4
"吴晓波频道",0,0,0,4,3,7
"呦呦鹿鸣",0,0,0,0,5,5
"周刊君",0,0,1,6,1,8
"周国平",0,0,0,3,0,3
"周密金融",23,0,0,4,6,33
"周蓬安的公众号",6,0,0,0,5,11
"周蓬安谈医改",0,0,1,2,2,5
"呼图壁零距离",0,0,0,1,0,1
"和田网警巡查执法",0,0,0,1,0,1
"咸宁发布",0,0,0,6,0,6
"哈佛商业评论",0,0,0,2,0,2
"哈密交警",0,0,0,2,0,2
"哈密伊吾消防119",0,0,0,1,0,1
"哈密市消防",0,0,0,1,0,1
"哈密市第二人民医院",0,0,0,1,0,1
"哈密电视台",0,0,0,1,0,1
"哈密铁检",0,0,0,1,0,1
"哈密零距离",0,0,0,2,0,2
"哈尔滨日报",0,0,0,5,1,6
"哥大全球中心",0,0,0,3,0,3
"哨兵观察员",0,0,0,0,1,1
"哩小咪主播",0,0,0,0,1,1
"哲学与政治",0,0,0,0,3,3
"哲学园",0,0,0,1,0,1
"商丘爆点",0,0,0,2,0,2
"商业人物",0,0,0,1,1,2
"商业周刊中文版",0,0,0,0,3,3
"商学院",0,0,0,2,0,2
"商界洞察",0,0,0,2,0,2
"商鞅谋略",0,0,0,0,3,3
"善思PsyEyes",0,0,0,0,2,2
"嘉兴第九区",0,0,0,7,0,7
"嘉盛集团",0,0,0,1,0,1
"四月网",0,0,0,2,10,12
"回族分享",0,0,0,2,0,2
"回族百年",0,0,0,6,2,8
"因信阅读",0,0,0,1,1,2
"团结湖参考",0,0,0,2,0,2
"囧囧搞笑笑话",0,0,0,6,0,6
"围炉",0,0,0,1,0,1
"国内国际爆料",0,0,0,2,4,6
"国学文化优选",0,6,0,6,1,13
"国学知音",0,0,0,1,0,1
"国家互联网应急中心CNCERT",0,0,0,1,0,1
"国家地理中文网",0,0,0,1,0,1
"国家税务总局",0,0,0,1,0,1
"国情要参",4,0,0,2,3,9
"国是直通车",0,0,0,3,1,4
"国电科环",0,0,0,1,0,1
"国科环宇",0,0,1,1,0,2
"国资小新",0,0,0,2,0,2
"国际在线",0,0,0,5,0,5
"国际局势解读",0,0,1,6,4,11
"国际日爆",0,0,0,0,1,1
"国际电讯",0,0,0,0,3,3
"国际贸易法评论",0,0,0,1,0,1
"国馆",0,0,0,5,1,6
"国馆文化",0,0,0,5,1,6
"圈内老鬼",0,0,0,1,0,1
"國語社",0,0,0,0,2,2
"土逗公社",3,0,0,0,1,4
"圣传真道网",6,0,0,1,8,15
"圣谛",0,0,0,1,1,2
"圣运律师",0,0,0,2,0,2
"在下林伯虎",0,0,0,2,1,3
"在遂宁",0,0,0,1,0,1
"地下水环境网",0,0,0,2,0,2
"地产八卦女",0,0,0,4,1,5
"地产微事件",0,0,0,1,0,1
"地合",0,0,0,1,1,2
"地心引力工场",0,0,0,3,0,3
"地球是透明的",0,0,0,0,1,1
"地球知识局",0,0,0,5,1,6
"坦腹斋",0,0,0,3,1,4
"城市绿洲报社",0,0,0,4,0,4
"城市零距离",0,0,0,0,1,1
"基本尚",0,0,0,0,1,1
"基督网",0,0,0,4,0,4
"境外社",0,0,0,0,1,1
"增城日报",0,0,0,6,0,6
"士兵之恋",0,0,0,0,1,1
"壹号收藏",0,0,0,4,0,4
"壹朵妖妖",0,0,0,0,1,1
"壹说",0,0,0,1,3,4
"壹读",0,0,0,1,2,3
"复兴军事",18,0,0,9,4,31
"复旦大学知和社",0,0,0,1,0,1
"复旦管院校友中心",0,0,0,4,0,4
"外交部发言人办公室",0,0,0,1,0,1
"外滩TheBund",0,0,0,1,0,1
"多彩贵州网",0,0,0,4,1,5
"夜听禅心",0,0,0,14,0,14
"大公网",0,0,0,1,0,1
"大千世界",0,0,2,2,12,16
"大午传承",0,0,0,1,0,1
"大午集团",0,0,0,1,0,1
"大囯阅览",0,0,0,5,2,7
"大地通讯",0,0,0,1,0,1
"大学生时光",0,0,0,4,0,4
"大学生那点事儿",0,0,0,2,0,2
"大宗早八点一览现货事",0,0,0,2,3,5
"大家",0,0,0,6,0,6
"大数据文摘",0,0,0,2,2,4
"大楚网",0,0,0,5,0,5
"大气科学进展AAS",0,0,0,1,0,1
"大江宁静",0,0,0,1,0,1
"大江网",0,0,1,11,0,12
"大河文摘",0,0,1,8,5,14
"大爱清尘基金",0,0,0,8,0,8
"大白新闻",0,0,0,8,1,9
"大白诊室",0,0,0,1,1,2
"大英良心汉弗莱",0,0,0,0,2,2
"大观新闻",0,0,0,2,0,2
"大象公会",0,0,0,2,1,3
"大连单身",0,0,0,10,0,10
"天下王家",0,0,0,7,6,13
"天下经观",0,0,0,0,2,2
"天下说法",0,0,1,1,2,4
"天天快讯",0,0,1,1,7,9
"天天时事汇",7,0,0,0,0,7
"天山老狼",0,0,0,2,1,3
"天水公安",0,0,0,2,0,2
"天津生态环境",0,0,0,2,0,2
"天涯时事",0,0,0,3,2,5
"天涯社区",0,0,2,16,6,24
"天狐视角",0,0,0,12,6,18
"天狐观察",0,0,0,18,6,24
"天狐观点",0,0,0,7,0,7
"太史瓷",0,0,0,3,0,3
"央广新闻",0,0,0,3,0,3
"央视新闻",0,0,0,2,0,2
"央视财经",0,0,0,2,0,2
"头条号",0,0,0,1,0,1
"奔波儿灞与灞波儿奔",0,0,0,11,1,12
"女儿派",0,0,0,3,0,3
"女律师札记",0,0,1,3,7,11
"女性之声",0,0,0,2,0,2
"女权时评圈",0,0,0,0,1,1
"女童保护",0,0,0,1,0,1
"女青年Online",0,0,0,3,4,7
"奴隶社会",0,0,0,2,1,3
"她刊",0,0,0,1,0,1
"她言他语",0,0,1,24,1,26
"好声音小仙女",0,0,0,1,0,1
"好奇心日报",0,0,0,3,2,5
"好看有你",0,0,0,0,1,1
"如东检察",0,0,0,1,0,1
"如果你站在冷风里5",0,0,0,1,0,1
"妈妈的阅读",0,0,0,2,0,2
"姜茶茶",0,0,0,3,1,4
"威海商务",0,0,0,4,0,4
"娱乐资本论",0,0,0,3,1,4
"婊酱FM",0,0,0,0,1,1
"婚姻保温站",0,0,0,2,0,2
"媒通社",0,0,0,2,5,7
"孙立平社会观察",0,0,0,1,5,6
"孝感槐荫论坛",0,0,0,2,0,2
"学习大潮",0,0,0,0,1,1
"学习小组",0,0,0,3,0,3
"学习语录",0,0,0,5,3,8
"学而思辨",0,0,0,0,2,2
"宁夏网虫",0,0,0,2,1,3
"安在",0,0,0,4,0,4
"安小幺",0,0,0,5,3,8
"安徽发布",0,0,0,11,0,11
"安徽纪检监察",0,0,0,1,0,1
"宋二请您啃咸菜",0,0,0,4,2,6
"宋二请您嚼咸菜",0,0,0,0,1,1
"宜兴发布",0,0,0,1,0,1
"实力美评",0,0,0,4,2,6
"实话实说II",0,0,0,21,2,23
"客家搜",0,0,0,14,0,14
"察网研究",0,0,0,3,17,20
"寻找中国创客",0,0,0,1,2,3
"寻找哑河",1,0,0,0,2,3
"寻找独角兽",0,0,0,2,0,2
"小兵说天下",0,0,0,0,2,2
"小刀酒馆",0,0,0,11,0,11
"小声比比",0,0,0,1,0,1
"小崔观世",0,0,1,1,2,4
"小崔说史",0,0,0,1,0,1
"小崔说实话l",0,0,1,9,5,15
"小崔说真话",0,0,0,9,3,12
"小彻小悟",0,0,0,0,2,2
"小明有爆料",0,0,0,4,0,4
"小疆有话说",0,0,0,1,0,1
"小道八卦",0,0,0,5,0,5
"小道消息",0,0,0,1,0,1
"小鲜电影",0,0,0,1,0,1
"尖椒部落",0,0,0,1,1,2
"尸人",0,0,1,21,4,26
"屋子里的树",0,0,0,0,1,1
"山东省人民检察院",0,0,0,5,0,5
"山大视点",0,0,0,3,0,3
"山西交警权威发布",0,0,0,4,0,4
"山西日报",0,0,0,15,0,15
"山西车管",0,0,0,2,0,2
"岛上车事",0,0,0,1,0,1
"岳阳爱尔眼科医院",0,0,0,1,0,1
"崔哥拉朽",0,0,0,8,0,8
"崔成浩",0,0,0,0,1,1
"川论",0,0,0,7,0,7
"左江日报",0,0,0,1,0,1
"巫小诗",0,0,0,2,0,2
"差评",0,0,0,3,1,4
"市界",0,0,0,1,2,3
"布谷岛",0,0,0,1,0,1
"帅帅职场屋",0,0,0,1,0,1
"师玥杂谈",0,0,1,0,4,5
"带你游遍英国",0,0,0,4,0,4
"帮忙大管家",0,0,0,1,0,1
"常州发布",0,0,0,2,0,2
"常州网",0,0,0,9,0,9
"平安和美河源",0,0,0,3,0,3
"平安哈密",0,0,0,1,0,1
"平安平顶山",0,0,0,1,0,1
"平定网",0,0,0,5,0,5
"平桥微宣",0,0,0,1,0,1
"平民新世界",0,0,2,27,5,34
"平湖在线",0,0,0,7,0,7
"平谷官话",0,0,0,5,0,5
"幸福武钢",0,0,0,2,0,2
"幸福福鼎",0,0,0,5,0,5
"乡闲",0,0,0,0,1,1
"广东共青团",0,0,1,0,0,1
"广东医院协会麻醉管理论坛",0,0,0,3,0,3
"广东省扶贫办",0,0,0,1,0,1
"广州太阳能光伏展",0,0,0,5,0,5
"广州性别中心",0,0,0,0,1,1
"广州日报",0,0,0,5,0,5
"广州财政",0,0,0,1,0,1
"广西新闻频道",0,0,0,17,0,17
"广西日报",0,0,0,6,0,6
"广西森林公安",0,0,0,1,0,1
"广西法治日报",0,0,0,2,0,2
"广西活动",0,0,0,2,2,4
"开始吧",0,0,0,1,0,1
"异想生活笔记",0,0,0,1,1,2
"张佳玮写字的地方",0,0,0,1,0,1
"张明宏观金融研究",0,0,0,1,0,1
"张鸣",0,0,0,0,11,11
"弯度",0,0,0,1,0,1
"强国梦",0,0,0,3,1,4
"强道逻辑",0,0,0,1,1,2
"当代公益",0,0,0,0,1,1
"彩虹见证团契",0,0,0,0,1,1
"彬彬有理",0,0,2,3,0,5
"很短",0,0,0,1,4,5
"很短2",0,0,0,0,5,5
"律动达人",0,0,0,8,2,10
"律商研究",0,0,0,8,0,8
"律界苑",0,0,1,4,0,5
"徐明纪实摄影工作室",0,0,0,1,0,1
"徐瑾经济人",0,0,0,0,9,9
"微工荟",2,0,0,0,7,9
"微思时代",0,0,0,3,2,5
"微悉尼",0,0,0,1,2,3
"微播宿迁",0,0,0,5,0,5
"微果酱",0,0,0,1,0,1
"微珀斯",0,0,1,1,0,2
"微观时局",0,0,2,35,8,45
"微言说法",0,0,0,2,0,2
"微说美国",0,0,0,1,0,1
"微铜仁",0,0,0,1,0,1
"德国优才计划",0,0,0,28,2,30
"德国华商",0,0,0,1,0,1
"德衡律师集团",0,0,0,2,0,2
"心灵摄影",0,0,0,3,0,3
"心理公开课",0,0,0,3,0,3
"心眼探世界",0,0,0,1,0,1
"思想与言论LTHY",0,0,0,0,1,1
"思想大视野",14,0,0,0,1,15
"思想报",8,0,0,0,6,14
"思想潮",0,0,0,3,1,4
"思想畈",0,0,0,0,1,1
"思想聚焦",0,0,0,6,0,6
"思维是一种信仰",0,0,0,5,0,5
"思辨喵",0,0,0,7,3,10
"性研究ing",0,0,0,1,0,1
"恐怖故事365天",0,0,0,3,2,5
"恒丰美林投资视界",0,0,1,1,3,5
"恩施发布",0,0,0,1,0,1
"恶意的隐喻",0,0,0,0,1,1
"悉尼印象",0,0,0,2,0,2
"您懂的",0,0,0,3,4,7
"意见领袖",0,0,0,0,1,1
"我们坚信2",0,0,0,5,6,11
"我到过的地方越来越多",0,0,0,7,0,7
"我在抱住",0,0,1,4,13,18
"我就BB怎么了",0,0,0,1,0,1
"我想逗乐这个闷闷的世界",0,0,0,1,0,1
"我是余生请多关照",0,0,0,1,0,1
"我是科学家iScientist",0,0,0,1,0,1
"我本罪臣Criminal",0,0,0,6,0,6
"我要WhatYouNeed",0,0,0,1,0,1
"手抄报",1,0,0,4,9,14
"手筑茯茶",0,0,0,0,2,2
"手谈姬",0,0,0,4,0,4
"才华有限的企鹅",0,0,0,0,4,4
"才华有限青年",0,0,0,2,0,2
"扑克投资家",0,0,0,4,0,4
"扒光金融圈",0,0,0,1,0,1
"打工者的梦工厂",0,0,0,1,0,1
"承德贴吧",0,0,0,1,0,1
"抄袭的艺术",0,0,0,1,0,1
"投资界",0,0,0,3,0,3
"抵抗睡前故事集",0,0,0,0,1,1
"押沙龙yashl",0,0,0,0,3,3
"拇指阅读",0,0,0,0,2,2
"拍者",0,0,0,2,0,2
"拙见",0,0,0,3,0,3
"招财大牛猫",0,0,0,1,3,4
"拨开迷雾看世界",0,0,0,1,0,1
"拾文化",0,0,0,1,0,1
"指间利川",0,0,0,1,0,1
"掌上内蒙古",0,0,0,4,0,4
"掌上千秋史",0,0,0,20,3,23
"掌上张家界",0,0,0,11,0,11
"掌上徐水",0,0,0,1,0,1
"掌上绵阳",0,0,0,1,0,1
"掌上驻马店",0,0,0,8,0,8
"掌心大同",0,0,0,3,0,3
"掌通徐州",0,0,0,0,1,1
"探索者",0,0,0,33,1,34
"推特每日精选",0,0,0,1,6,7
"揭阳广电",0,0,0,8,0,8
"搜索书生",0,0,0,2,0,2
"摆古论今",0,0,2,1,7,10
"摇滚客",0,0,1,35,10,46
"政事儿",0,0,0,1,0,1
"政在重庆",0,0,0,2,0,2
"政坛要参",0,0,0,0,2,2
"政局反腐",0,0,1,1,5,7
"政已阅",0,0,0,1,0,1
"政治学与国际关系论坛",0,0,0,0,1,1
"政治视野之光",21,0,0,1,1,23
"政知圈",0,0,0,3,0,3
"政经深观察",0,0,0,0,1,1
"政经观潮",0,0,0,8,15,23
"政见CNPolitics",0,0,0,1,0,1
"教你看透男人心",0,0,0,1,1,2
"教育面对面RBC",0,0,0,5,0,5
"敬主爱人伊路同行",14,0,0,0,0,14
"数博会",0,0,0,1,0,1
"文化先锋",0,0,0,0,1,1
"文史砍柴",0,0,0,1,2,3
"文学之友",0,0,0,1,2,3
"文明广州",0,0,0,1,0,1
"文明梅州",0,0,0,1,0,1
"文明海南",0,0,0,1,0,1
"文汇报",0,0,0,3,0,3
"文馆",0,0,0,0,4,4
"新三届",0,0,0,0,7,7
"新丝路金控",0,0,0,1,0,1
"新京报",0,0,0,5,1,6
"新京报评论",0,0,0,8,0,8
"新加坡红蚂蚁",0,0,0,0,1,1
"新华社",0,0,1,3,0,4
"新华视点",0,0,0,6,0,6
"新华网",0,0,0,6,0,6
"新台州",0,6,0,2,0,8
"新周刊",0,0,0,7,0,7
"新周猫",0,0,0,1,0,1
"新时代言思学社",0,0,0,0,6,6
"新昌发布",0,0,0,2,0,2
"新晚报",0,0,3,4,2,9
"新智元",0,0,0,1,3,4
"新校长传媒",0,0,0,1,0,1
"新榜",0,0,1,1,0,2
"新榜排行榜",0,0,0,2,2,4
"新民周刊",0,0,0,3,1,4
"新泽西华人资讯",0,0,0,1,0,1
"新流财经",0,0,0,1,0,1
"新湘江评论",0,0,0,14,16,30
"新源零距离",0,0,0,7,0,7
"新热点时评",0,0,0,1,0,1
"新生8",0,0,0,0,1,1
"新疆我的家",0,0,0,7,0,7
"新疆是个好地方",0,0,0,2,0,2
"新疆检察",0,0,0,3,0,3
"新疆财政",0,0,0,1,0,1
"新石扉客栈",0,0,0,1,1,2
"新老人",0,0,0,2,1,3
"新西兰中文在线",0,0,1,1,0,2
"新西兰天维网",0,0,0,1,0,1
"新财迷",0,0,0,3,0,3
"新退休生活",0,0,0,2,0,2
"新都蜀龙学校",0,0,0,1,0,1
"新金赛",0,0,0,4,1,5
"新闻哥",0,0,2,5,2,9
"新闻夜航",0,0,0,6,0,6
"新闻实验室",0,0,0,1,2,3
"新闻建外14号",0,0,0,1,0,1
"新闻早餐",0,0,1,7,4,12
"新闻晨报",0,0,0,1,0,1
"新青年",0,0,1,3,0,4
"新青年YouthTalks",0,2,0,0,0,2
"新顶尖悦读",0,0,0,0,2,2
"方舟子",0,0,0,0,1,1
"施一电气科技",0,0,0,2,0,2
"旁观中国",0,0,0,0,1,1
"无线徐州",0,0,0,1,0,1
"日本通",0,0,0,1,0,1
"日经中文网",0,0,0,0,1,1
"旧报刊剪辑",0,0,0,3,0,3
"时事政坛",0,0,0,25,1,26
"时事文史2",0,0,0,0,3,3
"时代微思",10,0,0,2,11,23
"时代涛声",0,0,0,5,0,5
"时代观察团",0,0,0,2,4,6
"时史文化",0,0,0,1,3,4
"时局报",0,0,1,34,11,46
"旺喜",0,0,0,0,1,1
"昆仑策研究院",0,0,0,6,14,20
"昆明信息港",0,0,0,2,0,2
"昌邑公安",0,0,0,1,0,1
"明源地产研究院",0,0,0,4,0,4
"明珠笔记",0,0,0,0,1,1
"明见书院",0,0,0,11,3,14
"明说全天下",0,0,0,0,2,2
"易居海外房产",0,0,1,0,2,3
"星系花园",2,0,0,0,0,2
"春来陌上",0,0,0,1,5,6
"春草微视",0,0,0,5,4,9
"显影",0,0,0,1,0,1
"晏凌羊",0,0,0,7,2,9
"晓看",0,0,0,1,2,3
"智东西",0,0,0,2,1,3
"智慧检务动态",0,0,0,1,0,1
"智谷趋势",0,0,0,4,24,28
"曲高和众",0,0,0,0,1,1
"曼哈顿资本圈",0,0,1,0,0,1
"有束光",5,0,0,1,0,6
"有西微语",0,0,0,1,2,3
"有趣青年",0,0,0,5,0,5
"望奎广电网",0,0,0,2,0,2
"朝報",0,0,0,2,5,7
"木棉雅韵",0,0,0,0,1,1
"木田无花",0,0,0,0,2,2
"末那大叔",0,0,0,3,0,3
"机器之心",0,0,0,3,1,4
"杂家LTHY",0,0,0,0,2,2
"李月亮",0,0,0,2,0,2
"李银河",0,0,0,3,0,3
"杜绍斐",0,0,0,2,1,3
"来点科学",0,0,0,1,0,1
"杨宝忠投资论坛",0,0,0,2,1,3
"杭州日报",0,0,0,1,0,1
"杭州本地宝",0,0,0,2,0,2
"林之音",0,0,0,1,0,1
"果因思维",0,0,0,1,0,1
"果壳",0,0,0,2,1,3
"果壳网",0,0,0,1,0,1
"柏举居士",0,0,0,7,2,9
"柳州发布",0,0,0,4,0,4
"校长会",0,4,1,2,0,7
"核心能力",0,0,0,0,1,1
"格林威治嬉皮研究公社",0,0,0,0,2,2
"桃子笔记",0,0,0,2,0,2
"梁子笔记",0,0,0,0,1,1
"梁惠王的云梦之泽",0,0,0,0,1,1
"梅州日报民生一线",0,0,0,2,0,2
"棱镜",0,0,0,4,0,4
"横山宣传",0,0,0,6,0,6
"橘子娱乐",0,0,0,4,0,4
"橙雨伞",0,0,0,1,0,1
"欧博管理咨询",0,0,0,1,0,1
"欧罗万象EuroScope",0,0,0,1,0,1
"正午故事",0,0,0,1,0,1
"正和岛",0,0,2,3,5,10
"正安001",0,0,0,11,0,11
"正洪观点",0,0,0,3,0,3
"此路不通",0,0,0,1,6,7
"武山圈子",0,0,0,11,3,14
"武志红",0,0,0,2,0,2
"武汉人在墨尔本",0,0,0,0,1,1
"武进微视",0,0,0,2,0,2
"每日人物",0,0,0,0,2,2
"每日经济新闻",0,0,0,3,2,5
"每日聚焦要闻",10,0,0,1,3,14
"毒舌女",0,0,0,5,2,7
"毒舌科技",0,0,0,0,4,4
"毛有话说",0,0,0,1,10,11
"民商事实务",0,0,1,4,0,5
"民族史",0,0,0,4,0,4
"民航小报报姐",0,0,0,10,0,10
"水彩写生",0,0,0,1,0,1
"水手美食",0,0,0,2,1,3
"水木然",0,0,0,20,0,20
"水煮历史",0,0,0,1,2,3
"水瓶座运势",0,0,0,2,3,5
"永和文化传媒",0,0,0,3,0,3
"永远的少数派",0,0,0,10,1,11
"求知之家",4,0,0,2,1,7
"汉南人",0,0,0,3,0,3
"汉尊2",0,0,0,0,2,2
"汉文化研究",0,0,0,2,7,9
"汉文化研究01",0,0,0,0,3,3
"江南晚报",0,0,0,5,0,5
"江南都市报",0,0,0,7,0,7
"江南隐士",0,0,1,9,3,13
"江西省教育厅",0,0,0,1,0,1
"江门交通运输",0,0,0,1,0,1
"江门职业技术学院",0,0,0,2,0,2
"池见新草",0,0,0,0,6,6
"池见草",0,0,0,0,4,4
"池见草3",0,0,0,0,3,3
"汪若鱼",0,0,0,3,4,7
"汽车金融",0,0,0,3,0,3
"沈阳新闻综合频道",0,0,0,2,0,2
"河北发布",0,0,0,1,0,1
"沸腾",0,0,0,1,2,3
"油品圈",0,0,0,1,0,1
"法之理",0,0,0,1,0,1
"法制网",0,0,0,3,0,3
"法务之家",0,0,0,0,3,3
"法学学术前沿",0,0,0,10,0,10
"法学律道",0,0,2,7,1,10
"法官论坛",0,0,0,1,0,1
"法律人天地",0,0,0,1,1,2
"法律读库",0,0,0,9,0,9
"法律门前",0,0,0,0,1,1
"法意读书",0,0,0,1,2,3
"法治乾坤",0,0,0,1,1,2
"法治智库",0,0,0,0,1,1
"法留香法律资讯",0,0,0,0,1,1
"法眼瞧世界",0,0,0,0,5,5
"法眼观察",0,0,0,10,3,13
"法耀星空",0,0,0,1,3,4
"法苑茶语",0,0,1,29,10,40
"法语如斯",0,0,0,0,4,4
"法门肆",0,0,0,1,0,1
"泰兴检察",0,0,0,1,0,1
"泸州老窖",0,0,0,3,0,3
"泽平宏观",0,0,0,1,1,2
"泾川发布",0,0,0,1,0,1
"洛杉矶e生活",0,0,0,0,4,4
"洛杉矶华人圈",0,0,0,5,4,9
"洛杉矶华人资讯网",0,0,2,1,1,4
"洛阳人事",0,0,0,13,0,13
"洞察真相",0,0,0,0,3,3
"洞见环球",0,0,0,0,2,2
"洞观视角",0,0,0,0,8,8
"津桥移民",0,0,0,0,1,1
"浙江五洲工程项目管理有限公司",0,0,0,5,0,5
"浙江我老家",0,0,0,42,0,42
"浙江新闻",0,0,0,1,0,1
"浪潮工作室",0,0,0,9,0,9
"浮山笔记",1,0,0,0,1,2
"海上闲话",0,0,0,0,2,2
"海关发布",0,0,0,1,0,1
"海国图智日播报",0,0,0,0,2,2
"海国图智研究院",0,0,0,1,1,2
"海外博士学者圈子",0,0,1,1,7,9
"海外探客",0,0,0,0,2,2
"海外独立频道",0,0,1,4,2,7
"海外网",0,0,0,6,0,6
"海外自由录",0,0,0,3,1,4
"海宁公安",0,0,0,1,0,1
"海宁市妇联",0,0,0,1,0,1
"海星星",4,0,0,1,4,9
"海涛评论",0,0,0,0,1,1
"海疆在线",0,0,0,0,5,5
"海豚学社",0,0,0,10,0,10
"海运仓内参",0,0,0,1,1,2
"海那边",0,0,0,3,2,5
"海门日报",0,0,1,3,0,4
"涛声一久",0,0,0,1,0,1
"淮安发布",0,0,0,3,0,3
"淮安检察",0,0,0,1,0,1
"深圳大件事",0,0,0,2,0,2
"深圳市龙岗区教育局",0,0,0,1,0,1
"深圳特区报",0,0,0,1,0,1
"深壹",0,0,0,5,2,7
"深度思考社",0,0,0,3,0,3
"深度时政",0,0,0,9,2,11
"深度时政2",0,0,0,6,0,6
"混乱博物馆",0,0,0,1,0,1
"清华大学清新时报",0,0,0,1,1,2
"清华管理评论",0,0,0,1,0,1
"清真学堂",0,0,0,1,0,1
"清谈润心",0,0,0,1,0,1
"渡过",0,0,0,1,0,1
"温哥华港湾",0,0,0,0,1,1
"温州网警巡查执法",0,0,0,1,0,1
"港台腔",0,0,0,1,0,1
"游郧西",0,0,0,2,0,2
"湖北发布",0,0,0,1,0,1
"湖北新闻",0,0,0,8,0,8
"湖北省人民政府网",0,0,0,3,0,3
"湖北私家车广播",0,0,0,2,0,2
"湖北经视",0,0,0,6,0,6
"湖南司法行政",0,0,0,2,0,2
"湖南工程职业技术学院",0,0,0,1,0,1
"滨海网信",0,0,0,3,0,3
"滚筒洗脑机",0,0,0,0,1,1
"演讲与人生",0,0,0,1,4,5
"漳平新闻网",0,0,0,7,0,7
"潇湘经略",0,0,0,0,1,1
"潘幸知",0,0,0,9,0,9
"潮州日报",0,0,0,1,1,2
"澎湃新闻",0,0,1,28,0,29
"澳华财经在线",0,0,0,0,4,4
"澳洲中文台",0,0,0,0,1,1
"澳洲微报",0,0,0,3,0,3
"澳洲第一传媒",0,0,1,0,0,1
"澳洲红领巾",0,0,4,4,0,8
"澳洲网",0,0,0,3,0,3
"灌南县人民检察院",0,0,0,1,0,1
"火星试验室",0,0,0,1,0,1
"火眼与金睛",0,0,1,0,0,1
"点亮未来",0,0,0,1,0,1
"烧伤超人阿宝",0,0,0,3,5,8
"焦点文刊",0,0,2,0,8,10
"焦点直通车",0,0,0,0,1,1
"煮酒君说史",0,0,0,2,1,3
"煮酒观天下",0,0,0,0,2,2
"煮酒论政",8,0,0,2,9,19
"熊园观察",0,0,0,1,0,1
"熊老六",0,0,0,2,11,13
"燕赵侠",0,0,0,1,0,1
"爱伊生活",0,0,1,1,7,9
"爱信仰与生活",2,0,0,1,1,4
"爱城华人",0,0,0,5,3,8
"爱尔兰驻华大使馆",0,0,0,1,0,1
"爱尚解放碑",0,0,0,1,0,1
"爱的家园",0,0,0,30,0,30
"爱的网络家园",0,0,0,15,0,15
"爱盘州",0,0,0,2,1,3
"爱范儿",0,0,0,7,1,8
"爱西宁社区",0,0,0,1,0,1
"牛山野夫读史记",0,0,0,3,1,4
"牛皮明明",0,0,0,1,1,2
"牧者讲道",0,0,0,0,1,1
"物流风向标",0,0,0,2,0,2
"独立作家",0,0,0,5,3,8
"独立视点2",0,0,0,0,5,5
"狮说新语",0,0,0,0,34,34
"狮门论坛",0,0,0,39,19,58
"狼族摄影",0,2,0,0,0,2
"狼眼资讯",0,0,0,2,5,7
"猛的号",0,0,0,0,3,3
"獨家",0,0,0,1,9,10
"玉东观察",0,0,2,0,2,4
"王不二",0,0,0,0,1,1
"王亚中律师",0,0,0,1,3,4
"王冲",2,0,0,0,1,3
"王左中右",0,0,0,0,2,2
"王志安",0,0,0,2,0,2
"王雅媛港股圈",0,0,0,1,7,8
"环保水圈",0,0,0,0,1,1
"环境与健康",0,0,0,1,0,1
"环境保护",0,0,0,2,0,2
"环球交叉点",0,0,0,3,0,3
"环球冷眼",0,0,0,21,13,34
"环球华人微刊",0,0,0,7,11,18
"环球时报",0,0,1,40,4,45
"环球时报英文版",0,0,0,2,0,2
"环球看热点",0,0,1,44,22,67
"环球神秘大事件",0,0,0,8,0,8
"环球网",0,0,1,15,0,16
"环球老虎财经",0,0,0,2,0,2
"现代资本主义研究",0,0,0,0,1,1
"现代金报",0,0,0,4,1,5
"珠江商报",0,0,0,2,0,2
"珠海民革",0,0,0,3,0,3
"珠海特区报",0,0,0,1,0,1
"珠海邻新闻",0,0,0,2,0,2
"琅琊新闻网",0,0,0,1,0,1
"理性乐观派",0,0,0,0,2,2
"瑞敏儿童教育资源",0,0,0,0,1,1
"生存意志",0,0,0,1,1,2
"生活报",0,0,0,2,0,2
"生活日报",0,0,0,2,0,2
"电商头条",0,0,0,2,0,2
"电商报",0,0,0,1,0,1
"电影工厂",0,0,0,7,1,8
"画友之家",0,0,0,11,1,12
"画友文学天地",0,0,0,0,1,1
"界面",0,0,0,10,3,13
"疯狂历史",0,0,0,1,0,1
"白天打灯笼",0,0,0,3,1,4
"白彤东",0,0,0,0,1,1
"白日做梦",0,0,0,43,1,44
"百万庄通讯社",0,0,0,5,0,5
"百姓关注话题",0,0,0,1,6,7
"百姓实话实説",0,0,0,2,1,3
"百姓放大镜",0,0,0,8,1,9
"百姓生计",9,0,0,1,16,26
"百姓监督",0,0,0,1,0,1
"百姓鉴政",0,0,0,6,12,18
"百年树人",0,0,0,5,5,10
"百道网",0,0,0,1,0,1
"盐城检察在线",0,0,0,3,0,3
"目以",0,0,2,1,9,12
"直新闻",0,0,0,1,0,1
"直面传媒",1,0,1,9,11,22
"看天下微杂志",0,0,0,1,0,1
"看客inSight",0,0,0,3,0,3
"看点曝料",0,0,1,4,5,10
"看理想",0,0,0,1,0,1
"看看新闻Knews",0,0,0,2,0,2
"看雪学院",0,0,0,1,0,1
"真实故事计划",0,0,0,3,1,4
"真理规划局",0,0,0,2,5,7
"真相与谎言",0,0,0,18,7,25
"瞭望",0,0,0,1,0,1
"瞭望智库",0,0,0,6,4,10
"知乎日报",0,0,0,1,0,1
"知微数据",0,0,0,1,0,1
"知无知",0,0,0,4,0,4
"知晓程序",0,0,1,1,1,3
"知识分子",0,0,0,3,0,3
"短史记",0,0,0,0,1,1
"石国鹏读书汇",0,0,0,1,6,7
"码洞",0,0,0,5,0,5
"砺剑",0,0,0,1,0,1
"社会科学报",0,0,0,1,0,1
"社會學會社",0,0,0,0,4,4
"祂是yesHEis",0,0,0,1,0,1
"视觉志",0,0,0,1,0,1
"视角",0,0,0,6,4,10
"视角学社",0,0,0,1,0,1
"神学教育与资源",0,0,0,1,0,1
"神州生气",0,0,0,12,4,16
"神计报税",0,0,0,2,0,2
"神雾集团",0,0,0,2,0,2
"禅城发布",0,0,0,1,1,2
"福州小鱼网",0,0,0,2,1,3
"福州新闻网",0,0,0,2,0,2
"福州新闻网+",0,0,0,1,0,1
"福州日报",0,0,0,5,0,5
"福建检察",0,0,0,6,0,6
"福清律师",0,0,0,2,0,2
"福音文摘",0,0,1,0,0,1
"私产经济学与伦理学",0,0,0,5,2,7
"科协改革进行时",0,0,0,3,0,3
"科技先锋",0,0,0,0,1,1
"科技日报",0,0,0,1,0,1
"科普中国",0,0,0,2,0,2
"秘闻爆光",0,0,0,0,1,1
"秦川雁塔",0,0,0,0,3,3
"秦朔朋友圈",0,0,0,0,1,1
"程序员小灰",0,0,0,7,0,7
"稻田报告",0,0,1,1,6,8
"穆之韵",0,0,0,1,0,1
"穆信之声",0,0,0,0,1,1
"空空道人厚黑堂",0,0,0,1,1,2
"穿透A股",0,0,0,1,0,1
"笑谈社",0,0,0,0,2,2
"第一房讯",0,0,0,2,0,2
"第一编剧",0,0,1,0,1,2
"第一财经",0,0,0,6,0,6
"第一财经网",0,8,0,0,0,8
"第十一诊室",0,0,0,1,0,1
"策略李立峰与行业配置笔记",0,0,0,1,1,2
"简笔笑画",0,0,0,15,4,19
"米国时刻",0,0,0,0,5,5
"米宅海外",0,0,0,3,2,5
"米尔军事网",0,0,1,14,4,19
"米筐投资",0,0,0,1,2,3
"粉巷财经",0,0,0,9,1,10
"粥左罗",0,0,0,1,0,1
"精英世界",0,0,3,19,2,24
"精英热闻",0,0,0,7,0,7
"精英趣闻",0,0,1,12,1,14
"素食",0,0,0,2,0,2
"紫竹张先生",2,0,0,2,0,4
"紫雪斋文化互助公益平台",0,0,1,0,1,2
"红星新闻",0,0,0,2,1,3
"红楼梦与毛选研究",0,0,0,0,1,1
"红河旅游",0,0,0,2,0,2
"红网论坛",0,0,0,1,0,1
"红色国魂",0,0,0,18,3,21
"红色往事",0,0,0,2,1,3
"红色快讯",17,0,0,1,4,22
"红色聚焦",0,0,0,27,4,31
"纪法指引",0,0,0,1,0,1
"纽约华人资讯网",0,0,0,0,2,2
"细读会着迷",0,0,0,1,5,6
"终端研发部",0,0,0,1,0,1
"经济学博士",0,0,0,4,8,12
"经济文摘2",0,0,0,0,2,2
"经济文摘3",0,0,0,0,1,1
"经济日报",0,0,0,4,0,4
"经济观察报书评",0,0,0,1,1,2
"经理人杂志",0,0,0,4,2,6
"经视法案",0,0,0,1,0,1
"经络养生网",0,0,0,1,0,1
"绝秘猛料",0,0,0,27,3,30
"继续寻光的彩虹君",2,0,0,0,1,3
"绫梨",0,0,0,1,0,1
"维基解迷",0,0,0,14,6,20
"绿色公民行动",0,0,0,1,0,1
"绿色和平行动派",0,0,0,1,0,1
"绿芽基金会",0,0,0,1,0,1
"网上江湖恩仇录",0,0,0,1,1,2
"网信吉林",0,0,0,2,0,2
"网信天津",0,0,0,2,0,2
"网易研究局",0,0,0,1,0,1
"网易财经",0,0,0,2,0,2
"网络新闻联播",0,0,0,1,0,1
"网络素养学",0,0,0,1,0,1
"罗四鸰阅读",0,0,0,1,1,2
"罗检在线",0,0,0,2,0,2
"罗西有意思",0,0,0,1,1,2
"美亚光电",0,0,0,1,0,1
"美国168资讯网",0,0,1,0,0,1
"美国亚裔资讯",0,0,0,2,0,2
"美国华人",0,0,0,1,1,2
"美国投资客",0,0,0,2,5,7
"美国时刻",0,0,0,0,1,1
"美国留学那点事",0,0,0,1,0,1
"美国驻华大使馆",0,0,0,1,0,1
"老K看天下",0,0,0,0,1,1
"老兵东雷",0,0,0,0,3,3
"老兵读史",0,0,0,2,1,3
"老刘的心灵鸡汤",0,0,1,5,1,7
"老挝要闻",0,0,0,2,0,2
"老斯基财经",0,0,0,0,1,1
"老斯基野驶",0,0,0,0,1,1
"老梁说真话",0,0,0,2,0,2
"老歌回放",0,0,0,3,2,5
"老河口手机台",0,0,0,2,0,2
"老端的观点",0,0,0,0,1,1
"老蛮数据透析站",1,0,0,0,5,6
"老车与店",0,0,0,19,1,20
"耒阳社区",0,0,0,19,1,20
"职场木沐说",0,0,0,17,0,17
"联合国世界粮食计划署",0,0,0,1,0,1
"联合国艾滋病规划署",0,0,0,1,0,1
"聚澳传媒",0,0,0,2,0,2
"聚焦于此",0,0,0,1,0,1
"肇庆街坊",0,0,0,5,0,5
"肖仲华开讲",0,0,0,1,2,3
"肖立晟宏观经济分析",0,0,0,1,0,1
"股票早午盘",0,0,0,1,1,2
"胡泳",0,0,0,0,1,1
"脉脉养生",0,0,0,7,1,8
"胶州人在线",0,0,0,13,0,13
"腾讯大成网",0,0,0,1,0,1
"腾讯证券",0,0,0,4,0,4
"腾飞讲史",0,0,0,12,0,12
"臧启玉律师",11,0,0,0,1,12
"自媒体",0,0,0,7,0,7
"自媒社",0,0,0,0,1,1
"自强News",0,0,0,2,0,2
"自由品读社",0,0,0,19,0,19
"自由新青年V",0,0,1,0,4,5
"自驾渔猎",0,0,0,0,1,1
"航空物语",0,0,0,1,0,1
"航运在线",0,0,0,0,1,1
"航通社",0,0,0,0,1,1
"良仓",0,0,0,1,0,1
"良庆发布",0,0,0,2,0,2
"艺非凡",0,0,0,7,0,7
"艾问人物",0,0,0,2,0,2
"芙蓉发布",0,0,0,1,0,1
"芜湖格力",0,0,0,3,0,3
"芝兰雅舍",6,0,0,1,0,7
"花儿街参考",0,0,0,0,1,1
"苍声",0,0,1,0,12,13
"苍山夜语",0,0,1,10,3,14
"苍山夜谈",0,0,0,5,1,6
"苍烟空老师",0,0,0,0,1,1
"苏州全接触",0,0,0,1,0,1
"苏州公安微警务",0,0,0,1,0,1
"苏州本地宝",0,0,0,1,0,1
"英伦大叔",0,0,0,2,0,2
"英国报姐",0,0,0,1,0,1
"英国那些事儿",0,0,0,3,1,4
"英文联播",0,0,0,0,2,2
"范学德",3,0,0,1,4,8
"草根清谈",0,0,0,1,0,1
"草野枫2",2,0,0,0,3,5
"草野枫3",0,0,0,0,1,1
"荟思想4",0,0,0,1,2,3
"荟思想5",0,0,0,1,8,9
"荟新知",0,0,0,1,0,1
"荣耀主基督",0,0,0,1,0,1
"药渡",0,0,0,2,1,3
"萌动律心二世",0,0,0,0,2,2
"营养健康生活馆",0,0,0,1,1,2
"营销新榜样",0,0,0,1,0,1
"萧内网萧山论坛",0,0,0,17,0,17
"萧山网",0,0,0,4,0,4
"葡萄酒",0,0,0,1,0,1
"葡萄酒研究",0,0,0,3,0,3
"葫芦岛网",0,0,0,34,1,35
"葫芦岛都市网",0,0,0,7,1,8
"蓝太阳亲子圈",0,0,0,2,0,2
"蓝莓公子",0,0,0,6,1,7
"蓝音盒",2,0,0,0,5,7
"蓝鲸浑水",0,0,0,2,0,2
"蓝鲸财经记者工作平台",0,0,0,2,0,2
"藏族论社会平台",0,0,0,1,0,1
"虎啸天",0,0,1,9,5,15
"虎嗅APP",0,0,1,15,11,27
"虎嗅网",0,0,0,0,8,8
"虎次郎",0,0,0,7,7,14
"蛋蛋网",0,0,1,2,1,4
"蜗牛与老鹰",0,0,0,0,2,2
"蜜蜂舆情",0,0,0,0,1,1
"蜜财经",0,0,0,3,1,4
"蝉创意",0,0,0,2,2,4
"融中财经",0,0,0,1,0,1
"行走与歌唱",0,0,0,1,3,4
"衡水大象传媒",0,0,0,7,0,7
"补壹刀",0,0,0,1,3,4
"裱糊匠不容易",0,0,0,0,4,4
"褚朝新",0,0,0,3,4,7
"西安RELAX同学社",0,0,0,2,0,2
"西安软件园",0,0,0,1,0,1
"西柚看电影",0,0,0,1,0,1
"西班牙欧华报",0,0,0,5,0,5
"西田城",0,0,0,1,0,1
"西雅图圣樱",0,0,1,0,2,3
"西雅图雷尼尔",0,0,0,2,0,2
"观察者网",8,0,0,29,6,43
"观点",0,0,0,10,6,16
"解放军报记者部",0,0,0,4,0,4
"言情说",0,0,0,10,1,11
"言江",0,0,0,1,0,1
"警探",0,0,0,1,0,1
"警用科技",0,0,0,1,0,1
"警笛",0,0,0,2,2,4
"讲武堂",0,0,0,4,0,4
"证券日报之声",0,0,0,0,1,1
"识政",0,0,0,1,0,1
"诗加生活",0,0,0,0,1,1
"诗意恩典",0,0,0,1,0,1
"话语生态研究",0,0,0,0,1,1
"误入仙境",0,0,0,1,0,1
"请尊重一个姑娘的努力",0,0,0,2,0,2
"读书人冯学荣",0,0,0,1,0,1
"读书梦",5,0,1,0,3,9
"读史",0,0,0,9,1,10
"读者",0,0,0,1,1,2
"读首诗再睡觉",0,0,0,1,0,1
"谈谈人事",6,0,0,0,6,12
"谷雨影像GuyuVision",0,0,0,1,0,1
"谷雨计划",0,0,0,1,0,1
"豪哥说车",0,0,0,1,0,1
"贡山警方",0,0,0,1,0,1
"财商焦点",0,0,1,7,3,11
"财富金家岭",0,0,0,1,0,1
"财新网",0,0,0,9,3,12
"财经",0,0,1,7,2,10
"财经国闻",0,0,1,15,2,18
"财经天下周刊",0,0,0,1,0,1
"财经女记者部落",0,0,0,2,1,3
"财经无忌",0,1,0,1,0,2
"财经要参",0,0,1,52,2,55
"财经记者圈",0,0,0,1,0,1
"质化研究",0,0,0,1,0,1
"贵州改革",0,0,0,4,0,4
"贵州检察",0,0,0,4,0,4
"贵州省人民政府网",0,0,0,1,0,1
"贵州省妇联",0,0,0,2,0,2
"贵州省纪委监委网站",0,0,0,3,0,3
"贵阳发布",0,0,0,1,0,1
"贵阳晚报",0,0,0,4,0,4
"贸易金融",0,0,0,2,1,3
"贺州城事",0,0,0,2,1,3
"资识研究所",0,0,0,0,1,1
"赞圣",0,0,0,3,1,4
"赞诵大师",0,0,0,0,11,11
"赣南日报",0,0,0,8,0,8
"赣州发布",0,0,0,3,0,3
"走出去智库CGGT",0,0,0,2,1,3
"走进新西兰",0,0,0,1,0,1
"起点人文plus",0,0,0,2,4,6
"超级学爸",0,0,0,0,6,6
"路以",0,0,0,0,8,8
"路财主N",0,0,0,0,4,4
"路透晚报",0,0,0,1,3,4
"躺倒鸭",0,0,0,1,0,1
"辩护人Defender",0,0,0,3,0,3
"辩护园地",0,0,0,0,3,3
"边疆反恐",0,0,0,1,0,1
"达琳镶嵌工厂",0,0,0,2,0,2
"近现代史论",0,0,0,1,3,4
"逍遥文摘",0,0,0,0,3,3
"透过图片看世界",0,0,0,1,22,23
"通往真理之路",0,0,0,10,4,14
"通辽女声",0,0,0,3,0,3
"逻辑熊猫带你玩Python",0,0,0,1,0,1
"遂昌新闻",0,0,0,3,0,3
"遗爱网",0,0,0,2,0,2
"遮眼看天",0,0,3,20,6,29
"遵义公安",0,0,0,1,0,1
"遵义教育",0,0,0,10,0,10
"邂逅社工",0,0,0,4,0,4
"邯郸交警微发布",0,0,0,2,0,2
"邳州银杏甲天下",0,0,0,4,0,4
"郑州新浪乐居",0,0,1,2,0,3
"郑益铸信工作室",5,0,0,5,2,12
"郭一平发声",0,0,2,4,3,9
"郭一平心念黎民",0,0,1,1,3,5
"郭一平说真话",0,0,2,2,9,13
"郭松民的散兵坑",0,0,0,3,1,4
"都市快报",0,0,0,10,0,10
"鄂温克旗侨胞之家",0,0,0,2,0,2
"鄱湖渔夫",0,0,0,1,2,3
"酷玩实验室",0,0,0,4,2,6
"重庆交巡警",0,0,0,5,0,5
"重庆剁手党",0,0,0,2,0,2
"重庆女性",0,0,0,1,0,1
"重建巴别塔",3,0,0,1,1,5
"重案组37号",0,0,0,2,0,2
"野玩儿",0,0,0,1,0,1
"野视频",0,0,0,3,3,6
"野马财经",0,0,0,1,0,1
"野马青年",0,0,0,1,0,1
"量化级掌柜",0,0,0,1,1,2
"量子人生",0,0,0,0,4,4
"量子位",0,0,0,5,2,7
"金创黄金",0,0,0,0,1,1
"金口娱言",0,0,0,0,4,4
"金峰国际饭店集团",0,0,0,2,0,2
"金昌公安",0,0,0,1,0,1
"金杜研究院",0,0,0,2,0,2
"金脑袋营销策划",0,0,0,2,2,4
"金融五道口",0,0,0,9,13,22
"金融八卦女频道",0,0,0,3,2,5
"金融茶社",0,0,0,1,8,9
"金融霸主",0,0,0,1,3,4
"金轮新月",16,0,0,0,4,20
"鑫泽法律咨询",0,0,0,1,0,1
"钛媒体",0,0,0,0,3,3
"钟二毛",0,0,0,3,0,3
"钱江晚报",0,0,0,11,0,11
"铁血军事",0,0,0,7,5,12
"铁血军事网",0,0,0,7,0,7
"铁血军魂网",0,0,0,12,3,15
"铁血督查网",0,0,1,1,5,7
"铅笔道",0,0,0,3,0,3
"铜仁公安",0,0,0,5,0,5
"铜川人社",0,0,0,2,0,2
"银川新闻网",0,0,0,3,0,3
"锐视界",5,0,0,0,0,5
"锐见锐评",2,0,0,1,2,5
"锡林郭勒晚报",0,0,0,3,0,3
"镜湖鉴政",0,0,0,4,1,5
"长兴人",0,0,1,2,1,4
"长安街知事",0,0,1,12,1,14
"长江商学院MBA",0,0,0,1,0,1
"长江新闻号",0,0,0,1,0,1
"长沙市青少年宫",0,0,0,2,0,2
"闲时花开",0,0,0,1,2,3
"闻道无先后",0,0,0,2,8,10
"闽南网漳州",0,0,0,2,0,2
"阅天下百事",0,0,0,0,2,2
"阳光一生",0,0,1,0,0,1
"阳光下的大叔",0,0,0,1,0,1
"阿SIR",0,0,1,8,0,9
"阿丹读书会",0,0,0,1,2,3
"阿勒泰市北屯镇发布",0,0,0,1,0,1
"阿勒泰市教育局",0,0,0,1,0,1
"阿勒泰市消防",0,0,0,1,0,1
"阿勒泰市零距离",0,0,0,11,0,11
"阿呆继续曰",0,0,0,0,1,1
"阿语迷",0,0,0,8,2,10
"陀废论",4,0,0,0,1,5
"陆家嘴共享图书馆",0,0,0,1,1,2
"陆家嘴制高点",0,0,0,1,0,1
"陈基强",0,0,0,1,1,2
"陈履生美术馆",0,0,0,4,0,4
"陈浩武",0,0,0,0,3,3
"陈见说",0,0,0,1,0,1
"陕西泽诚律师事务所",0,0,0,1,0,1
"陕西都市快报",0,0,0,2,0,2
"隐私护卫队",0,0,0,0,1,1
"难得视界",0,0,0,11,11,22
"集中爆料",0,0,0,0,1,1
"集美大学",0,0,0,2,0,2
"雪夜闭门读晋书",0,0,0,0,1,1
"雪漠禅坛",0,0,0,2,0,2
"雾满拦江",0,0,0,0,1,1
"霍老爷",3,0,0,0,3,6
"霹雳炮",0,0,0,1,10,11
"青塔",0,0,0,4,1,5
"青岛大众网",0,0,1,11,0,12
"青岛早报",0,0,0,2,0,2
"青年力",0,0,0,1,2,3
"青年电影手册",0,0,0,2,0,2
"青春中澳",0,0,0,2,0,2
"青春山东",0,0,0,1,0,1
"青春江干",0,0,0,1,0,1
"青木长刀",0,0,0,0,2,2
"青杏熟了",0,0,0,4,0,4
"青杨有话说",0,0,0,1,2,3
"非常历史",0,0,0,2,3,5
"非洲时报",0,0,0,2,1,3
"非著名程序员",0,0,1,0,0,1
"韩国驻华大使馆",0,0,0,1,0,1
"韩城周边大小事",0,0,0,42,0,42
"顶级黑幕",0,0,1,4,8,13
"顾颖琼博士说天下",0,0,0,2,6,8
"领带职场圈儿",0,0,0,0,1,1
"颜辞",0,0,0,29,0,29
"風聲評論",0,0,0,2,2,4
"风声照旧",0,0,0,0,4,4
"风说贴",0,0,0,0,1,1
"餐饮老板内参",0,0,1,1,0,2
"饭特特稀",0,0,0,0,4,4
"首席发言者",0,0,0,2,0,2
"骚客文艺",0,0,0,0,2,2
"高安百事通",0,0,0,13,3,16
"高度一万五千米",0,0,0,1,0,1
"高明发布",0,0,0,1,0,1
"高碎说一不二",0,0,0,2,4,6
"鬼师兄讲鬼故事",0,0,0,2,2,4
"鬼眼浮世绘",0,0,0,1,11,12
"魏雅华",0,0,0,1,6,7
"魔都囡",0,0,0,5,2,7
"鲁稚的阳台",0,0,0,4,0,4
"鲁网临沂",0,0,0,4,0,4
"鹅城段子",1,0,0,1,3,5
"鹏友pengyou",6,0,0,0,2,8
"鹰潭日报",0,0,0,1,0,1
"麻辣未闻",0,0,0,3,0,3
"黄河新闻网",0,0,0,2,0,2
"黄花小美女",0,0,0,4,0,4
"黑夜中奔跑",0,0,0,0,2,2
"黑夜问灯",0,0,0,1,1,2
"黑岩网",0,0,0,53,0,53
"黑幕实报",8,0,1,2,6,17
"黑幕揭晓",0,0,0,0,9,9
"黑幕观察",0,0,0,4,4,8
"黑白之道",0,0,1,2,0,3
"黑白先生",0,0,0,2,2,4
"黑門",0,0,0,0,1,1
"黑龙江交通广播",0,0,0,5,0,5
"黑龙江晨报",0,0,0,8,1,9
"墨香学术",0,0,0,0,1,1
"黔东南信息港",0,0,0,1,0,1
"黔东南公安",0,0,0,1,0,1
"黔西南公安",0,0,0,3,0,3
"鼎湖发布",0,0,0,1,0,1
"齐俊杰看财经",0,0,0,0,2,2
"龙之声论坛",0,0,0,1,1,2
"龙岩网",0,0,0,2,0,2
"龙视新闻在线",0,0,0,3,0,3
"龙腾财经LTHY",0,0,0,0,2,2
"龙虎政能量",0,0,0,2,0,2
"龙虎文旅",0,0,0,1,0,1
